####################
#  ######     #    #
#     #  ##   ##   #
#             ##   #
# ######           #
# ###   ###    ##  #
#              ##  #
#   #######     ## #
#   ##########   ###
#   ########     ###
#                  #
#         ###  ### #
#########   #  ### #
#       #   ###### #
####### #   # # #  #
#       #   # # #  #
# #######     #    #
#      ##   #####  #
#####        ###   #
####################
